CREATE TABLE project.sbaloans(
index CHAR,	
BorrName CHAR,	
BorrStreet CHAR,	
BorrCity	CHAR,
BorrState	CHAR,
BorrZip	 CHAR,
BankName	CHAR,
BankStreet	CHAR,
BankCity	CHAR,
BankState	CHAR,
BankZip	CHAR,
GrossApproval CHAR,	
SBAGuaranteedApproval	CHAR,
ApprovalDate	DATE,
ApprovalFiscalYear	CHAR,
FirstDisbursementDate	DATE,
DeliveryMethod	CHAR,
subpgmdesc	CHAR,
InitialInterestRate	int,
TermInMonths	int,
NaicsCode	CHAR,
NaicsDescription	CHAR,
FranchiseCode	CHAR,
FranchiseName	CHAR,
ProjectCounty	CHAR,
ProjectState	CHAR,
SBADistrictOffice	CHAR,
CongressionalDistrict	CHAR,
BusinessType	CHAR,
LoanStatus	CHAR,
PaidInFullDate	DATE,
ChargeOffDate	DATE
GrossChargeOffAmount	int
RevolverStatus	int,
JobsSupported int
);
